




NO ./2d_imgs/ICEYROCKS.xpm




SO ./2d_imgs/ICEYROCKS.xpm




WE ./2d_imgs/ICEYROCKS.xpm



EA ./2d_imgs/ICEYROCKS.xpm





F 221,11,21



C 55,33,44







11111    1111111111111
10001    1000000000001
10N11    1000000010001
1000111111100100000001
1000000000000100000001
111111111111111111111111111







