NO ./2d_imgs/ICEYROCKS.xpm
SO ./2d_imgs/ICEYROCKS.xpm
WE ./2d_imgs/ICEYROCKS.xpm
EA ./2d_imgs/ICEYROCKS.xpm
F 221,11,21
 t 55,33,44
11111111
100S0001
11111111