NO ./2d_imgs/ICEYROCKS.xpm
SO ./2d_imgs/ICEYROCKS.xpm
WE ./2d_imgs/ICEYROCKS.xpm
EA ./2d_imgs/ICEYROCKS.xpm


F 220,100,0
C 225,30,0


1111111111
10N0000001
1000111101
11111