

NO ./2d_imgs/ICEYROCKS.xpm



a


SO ./2d_imgs/ICEYROCKS.xpm



WE ./2d_imgs/ICEYROCKS.xpm



EA ./2d_imgs/ICEYROCKS.xpm

F 221,11,21
C 55,33,44

11101111
10000001
10000001
1000N001
10000001
10000001
10000001
11111111