
NO ./2d_imgs/ICEYROCKS.xpm



SO ./2d_imgs/ICEYROCKS.xpm


WE ./2d_imgs/ICEYROCKS.xpm


EA ./2d_imgs/ICEYROCKS.xpm
F 221,11,21
C 55,33,44
11111111
10000001   11111
10000001   10001
1000N00111110001
10000001   10001
10000001   11111
10000001
11111111








1