NO ./path_to_the_north_texture
SO ./path_to_the_south_texture
WE ./path_to_the_west_texture
EA ./path_to_the_east_texture
11111    1111111111111
10001    1000000000001
10N11    1000000010001
1000111111100100000001
1000000000000100000001
111111111111111111111111111
11    1
11    1
11    1
1
1
1
1
1
1
11111111111111111111111
10000000000000000000001
10000000000000000000001
11111111111111111111111