WE ./2d_imgs/ice_cat.xpm

NO ./2d_imgs/cute_cat.xpm

EA ./2d_imgs/pixel_cat.xpm
F   51,   164,   166
C       126,        170,          252
SO ./2d_imgs/cat.xpm

1111111111111111
1000100000000001
1011100001111011
1000000001100011
1000N00001101111
1010100000101011
1010100000000001
1111111111111111

