NO ./path_to_the_north_texture
SO ./path_to_the_south_texture
WE ./path_to_the_west_texture
EA ./path_to_the_east_texture

F 50,168,82
C 44,22,111


11111111
10000001
10000001
1000S001
10000001
10111001
10000001
11111111

