NO ./2d_imgs/player.xpm
SO ./2d_imgs/player.xpm
EA ./2d_imgs/player.xpm
WE ./2d_imgs/player.xpm

F 50,168,82
C 44,22,111


11111111
10000001
10000001
10N00001
10000001
10000001
10001001
11111111

