NO ./path_to_the_north_texture
SO ./path_to_the_south_texture
WE ./path_to_the_west_texture
EA ./path_to_the_east_texture
11111111
10000001
10000001
1000N0011111
10000001
10000001
10000001
11111111