NO ./2d_imgs/wall.xpm
SO ./2d_imgs/player.xpm
EA ./2d_imgs/player.xpm
WE ./2d_imgs/player.xpm

F 50,168,82
C 44,22,111


111111111
10001001
10111001
10N00001
10000001
10101001
10101001
11111111

