NO ./2d_imgs/north_wall.xpm
SO ./2d_imgs/south_wall.xpm
EA ./2d_imgs/east_wall.xpm
WE ./2d_imgs/west_wall.xpm

F 255,1,1
C 255,1,1

1111111111111111
1N00100001111111
1011100001111011
1000000001111111
1000000001111111
1010100000111111
1010100000111111
1111111111111111