NO ./2d_imgs/north_wall.xpm
SO ./2d_imgs/south_wall.xpm
EA ./2d_imgs/east_wall.xpm
WE ./2d_imgs/west_wall.xpm

F 97,87,90
C 156,8,47

1111111111111111
1000100001111111
1011100001111011
1000000001111111
10N0000001111111
1010100000111111
1010100000111111
1111111111111111