NO ./2d_imgs/highRes.xpm
SO ./2d_imgs/highRes.xpm
EA ./2d_imgs/highRes.xpm
WE ./2d_imgs/highRes.xpm


F 200,200,200
C 230,230,230

        1111111111111111111111111
        1000000000110010101010011
        1011000000000000000000001
        1001000000000001000N00001
111111111011000001110001000100011
100000000011000001110001111111111
11110111111111011100000010001
11110111111111011101010010001
11000000110101011100000010001
10000000000000001100000010001
10000000000000001101010010001
11000001110101011111011110001
11110111 1110101 101111010001
11111111 1111111 111111111111
