
NO ./2d_imgs/north_wall.xpm


SO ./2d_imgs/south_wall.xpm

EA ./2d_imgs/east_wall.xpm



WE ./2d_imgs/west_wall.xpm


F 0,0,0

C 200,200,200
                 111
                 101
              111101111
              100000001
111111111111111000000011111
1000N000000000000000000001
100000000000000000000000111
1000000000111111111111111
10000001111
111000011
  1100011
  1111111


