
NO ./2d_imgs/north_wall.xpm


SO ./2d_imgs/south_wall.xpm

EA ./2d_imgs/east_wall.xpm



WE ./2d_imgs/west_wall.xpm


F 200,200,200

C 230,230,230


111111111
100000001
1000000011111
1000N00000001
1000000000111
1000000000111
10000001111
111000011
  1100011
  1111111


