
NO ./2d_imgs/f.xpm



SO ./2d_imgs/f.xpm


WE ./2d_imgs/f.xpm


F      50,     50,    50


   C       200,      200,    200

EA ./2d_imgs/f.xpm





11111111
10000001   11111
10000001   10001
1000N00111110001
10000001   10001
10000001   11111
10000001
11111111
11111111
10000001   11111
10000001   10001
1000000111110001
10000001   10001
10000001   11111
10000001
11111111
11111111
10000001   11111
10000001   10001
1000000111110001
10000001   10001
10000001   11111
10000001
11111111
11111111
10000001   11111
10000001   10001
1000000111110001
10000001   10001
10000001   11111
10000001
11111111
11111111
10000001   11111
10000001   10001
1000000111110001
10000001   10001
10000001   11111
10000001
11111111       

